11 9
5 - purple buttons
////////////
/B......#../
////.//.//1/
  /A....2../
  //./////./
   /..Zx.../
   /////////
