4 5
10 - sharing is caring
  ///    ///
  /C/    /A/
  /./   //.//
  /1/   /.../
///#/////.#./
/B....32..../
//X...///.y./
 ////// /////
