11 11
11 - togetherness
//////////
/W//....B/
/../1//../
/..2..1../
/..//2/../
/A....//y/
//////////
