7 7
14 - put the thing on the thing
//////////
/WC....../
/.#..../3/
/A.B.../2/
////////4/
  /D/..../
  /.1../y/
  ////////
