10 10
17 - down and up
   ////////
  //.aB.../
///.Z/x././
/...A/.//./
/./..b./../
/.//////.//
/......../
//////////
