6 13
18 - boxing match
/////     ////
/.A.///////.z/
/.../....1.../
/..///.////#//
/.Z/B......../
/2///./#/#/.//
/..3........C/
//////////////
