11 10
19 - preparation is key
    //////
/////...z//
/.../1/.../
/./.2./1/./
/./2///.../
/...///././
/X..A/B.../
///////////
