14 14
21 - see saw
//////////////
/W..6.57.8..w/
/.B.//////.A./
/./..D#.C.././
/1//////////2/
/.3.#E//G..4./
///.#F//H#.///
  //////////
