4 17
27 - reach around
      /////
      /..C/////
///////.////../
/.X.42..15.3../
/../////////../
//.....C....../
 /x..AB#DE#.../
 //////////////
