12 12
28 - boxes, boxes everywhere
//////////////
/..W.B//D.w.C/
/#...#//.#.#./
/.#.#A//.##../
/..#..//E...#/
/3//////////1/
/..5...2..4../
//////////////
